###########################
#.....#...................#
#.....#...................#
#.....#...................#
###$###...................#
#.........................#
#.........................#
#.........................#
#.........................#
#.........................#
#.........................#
#.........................#
#.........................#
#.........................#
#.........................#
###########################