###########################
#.....#...................#
#.....#...................#
#.....#...................#
###$###...................#
#.........................#
#.........................#
#.........................#
#.........................#
#...........######........#
#.........................#
#....#....................#
#....#....................#
#....#....................#
#....#....................#
#....#.......#####........#
#.........................#
#.........................#
#.........................#
#.........................#
#.........................#
#.........................#
#.........................#
#.........................#
#...................#.....#
#...................#.....#
#...................#.....#
###########################